111111111111111111101111111111111111111111
1EEEEEEEEEEEEEEEEEEEEEEEEEEEEEEEEEEEEEEEE1
1E11111111111111111111111111111111111111E1
1EEEEEEEEEEEEEEEEEEEEEEEEEEEEEEEEEEEEEEEE1
1EEEEE1EEE1111111E11E11E111111111111111EE1
1EEFEE1EEEEEEEEEEE1EEE1EEEEEEEEEEEEEEFEEE1
11111110111111111E11E1111111E1111111111111
0EEEEEEEEEEE1EEEEEEEEEEEEEE1EEEEEEEEEEEEE0
11111111111E101111110111111111111111111111
1EEEEEEEEEEEEEEEEE1MMM1EEEEEEEEEEEEEEEEEE1
1EEEEE1EEEEEESEEEE11011EEE111111111111EEE1
1E11EE1EEE1EEEEEEEEEEEEEEE111111111111EEE1
0E11EEEEEE1EEEEEEEEEEEEEEEEEEEEEEEEEEEEEE0
1E11EE1EEE1EEE111111EEEE11111111111111EEE1
1E11EE1EEE1EEEEEEEEEEEEEEEEEEEEEEEEEEEEEE1
1E11EE1EEE1EEE111111111111111111111111EEE1
1E11EE1EEEEEEEEEEEEEEEEEEEEEEEEEEEEEEEEEE1
1EEFEE1EE1111111111011111111E111111111EEE1
1EEEEEEEEEEEEEEEEEEEEEEEEEEEEEEEEEEEEEEEE1
111111111111111111101111111111111111111111