11111111111111111111111111111111111111
00000000011EEEEEEEESEEEEEEE11000000000
11111111011E11E11111111E11E11011111111
11FEEEEEEEEE11EEEE11EEEE11EEEEEEEEEF11
11E11111E11E11111E11E11111E11E11111E11
11EEEE11E11EEEEEEEEEEEEEEEE11E11EEEE11
11111E11E11111E11111111E11111E11E11111
00011EEEEEEEEEEEEE11EEEEEEEEEEEEE11000
00011E11111E11111E11E11111E11111E11000
00011E11111E11000000000011E11111E11000
11111E11111E11011100111011E11111E11111
11EEEEEEEEEE00010MMMM01000EEEEEEEEEE11
11E11111E11111011111111011111E11111E11
11E11EEEEEEE11000000000011EEEEEEE11E11
11E11E11111E11011111111011E11111E11E11
11EEEE11111EEEE00011000EEEE11111EEEE11
11E11E11111E11011011011E11E11111E11E11
11E11EEEEEEE11011000011E11EEEEEEE11E11
11E11111E11111011111111E11111E11111E11
11FEEEEEEEEEEEEEEEEEEEEEEEEEEEEEEEEF11
11111111011E11111E11E11111E11011111111
00000000011EEEEEEE11EEEEEEE11000000000
11111111111111111111111111111111111111